@@@@@@@
@.....@
@@...@@
@@.@.@@
@@@@@@@
