@@@@@@@
@@....@
@@.@.@@
@....@@
@@@@@@@