@@@@@@@
@.....@
@@.@.@@
@.....@
@@@@@@@