@@@@@@
@.@..@
@....@
@....@
@...@@
@@@@@@
