@@@@@@
@....@
@@...@
@...@@
@...@@
@@@@@@
