@@@@@@
@....@
@@...@
@....@
@....@
@@@@@@
