@@@@@@
@....@
@...@@
@@..@@
@....@
@@@@@@
