@@@@@@
@.@..@
@....@
@....@
@..@@@
@@@@@@
