@@@@@@@
@....@@
@..@..@
@.@@..@
@..@@@@
@.....@
@@@@@@@
