@@@@@@@
@..@@@@
@..@..@
@....@@
@@....@
@...@.@
@@@@@@@
