@@@@@@@
@....@@
@..@..@
@.@@..@
@..@..@
@.....@
@@@@@@@
