@@@@@@@
@.@@..@
@.....@
@.....@
@.....@
@.....@
@@@@@@@
