@@@@@@@
@....@@
@.....@
@.....@
@...@.@
@.....@
@@@@@@@
