@@@@@@@
@..@.@@
@..@..@
@.....@
@...@.@
@....@@
@@@@@@@
