@@@@@@@
@..@@.@
@@....@
@.@...@
@.....@
@...@.@
@@@@@@@
