@@@@@@@
@.@@..@
@....@@
@@@...@
@.....@
@...@@@
@@@@@@@
